NOMATCH		raade	raad	raadt	rade
NOMATCH		hooftquartier	hoofdquartier
NOMATCH		staat	staats	staten	standen	stenden
Strand		strandt	strant
Koninkrijk		coninkryk	koningryk
Kreits		kreytzen	slackkreyts
Landschapshuis		land-schaps-huys
Provinciehuis		provincie-huys	provinciehuys
Vorstendom		vorstendom	vorstendombs	vorstendommen	vorstendoms	furstendom	furstendomb	furstendombs
Kamp		camp
Dorpen	Dorp	dorps
Landschap		landschap	landschappe	landtschap	landtschappe	landtschaps	schaps
Land		landts	land	lande	landen	lands
Markizaat		marquysaat	marquysaats	marquyzaat	marquyzaats
Pastorie		pastorye
Prinsdom	Vorstendom	prinsdom	prinschdom
Provincie		prouyn	prove	provin	province	provincie	provincien	provincio	vincien	prouyncie	prouyncien	prouyntie	prouyntien
Rijk	Gebied	rycx	ryk	ryken	ryks	rykx
Stad		stads	stadts	stad	stad'	stad's	stede	stedeken	steden	steede	steedeke	steeden	sad	steedje	tad	steedje	stadt van	stad van	stat van	stede van
Abdij		abdye	abtdye
Ambacht		ambacht	ambachte	ambachten	ampt	ampte	ampts
Baai		baay	bay	baye
Balie	Bank	baillie	bailluagie	baillye	ballie	ballye	balye
Baronie		baronie	baronnie	baronnye	baronye
Benedenkwartier	Kwartier	beneedenquartier
Bisdom		bisdom
Hofstede		hofsteede
Bovenkwartier	Kwartier	boovenquartier	bovenquartier
Buitenwijk		faubourg
Citadel	Fort	citadelle
Commanderij		commanderie	commanderye
District		district	districten	distriet	distri√©t
Domein	Gebied	domain	domainen	domeinen	domeynen
Dorp		dorp	dorpe	dorpen	dorperen
Eiland		eiland	eilande	eilanden	eilands	ellands	ellands	erflanden	eyland	eylande	eylanden	eylands	eland
Fort		fort	forten	fortresse	forteresse
Gebied		gebied	gelanden
Gehucht	Dorp	gehuchten
Graafschap		graaffschap	graaffschappe	graaffschaps	graafschap	graafschappe	graafschaps	graasschappe
Grens		frontieren	grensen	limiten	limitscheydinge
Grensstad	Stad	frontier	frontiersteden
Grondgebied	Gebied	byvang	byvank	territoir
Grondheerlijkheid	Heerlijkheid	grondheerlykheid
Haven		haven	havene	havenen	havens
Heerlijkheid		heerlicheyt	heerlikheyt	heerlykheden	heerlykheeden	heerlykheid	heerlykheyd	heerlykheydt	heerlykheyt	vrye-heerlykheydt
Hertogdom		hartochdom	hartochdom	hertochdom	hertochdoms	hertogdom	hertogdommen
Hoofdstad	Stad	hoofastad	hoofdstad	hoofdstad's	hooftstad
Kanaal		canaal	canal
Kanton		canton	cantons
Kasselrij		casselenye	casselerye	casseleryen	castelenye
Kasteel		casteel	kasteel
Kerk		kerken	kerken	kerke
Kerspel		kerspel
Klooster	Abdij	clooster	klooster
Kolonie		colonie	colonien
Kust		cust	custe	custen	kust	kuste	kusten
Kwartier		quartier	quartiere	quartieren	quartiers
Landerijen	Gebied	landeryen
Plantage		plantage	plantagie	plantagien
Platteland	Gebied	plattelanden
Polder		polder	polders	palder
Prinsbisdom	Bisdom	aarts-stift	aartsstift	aartzstift	hoogstift
Republiek		repubicq	republicq	republicque	republieq	republycq	republycque
Rijksstad	Stad	ryks-stad	ryksstad	rycxstad	ryks stad
Rivier		rivier	riviere	rivieren	rio	revier	reviere
Schans	Fort	schansse	schans	schanssen
Stadhuis		stadthuys
Vallei	Gebied	valeye	valeyen	valleyen	valleyen
Zeehaven	Haven	zeehaven	zeehavens
Kapel		capelle
Parochie		parochie
Vesting	Fort	barriere	vesting	vestinge
Meierij	Gebied	mayerie	mejerie	meverye	meyere	meyerie	meyerievan	meyerve	meyerye	meyerye-van
Noorderkwartier	Kwartier	noorder-quartier	noorderquartier	noorderquartiere
Onderkwartier	Kwartier	onderquartier
Oostkwartier	Kwartier	oostquartier
Overkwartier	Kwartier	over-quartier	overduartier	overquartier	overquartiers	overavartier
Palts		paltz
Westkwartier	Kwartier	westquartier
Noordergedeelte	Gebied	noordergedeelte
Sticht	Bisdom	sticht	stiff	stiffs	stiffs	stift	stifts
Burg	Fort	burg
Gemeente		gemeente
Kaap		kaap	cabo
Mark		mark
Port	Haven	port	porta	porto
Rede		rheede	reede	rede	rhede
Straat		straat
Vlek	Dorp	vlek
Watering		wateringe
Wedde		wedde
Wijk		wyk
Burcht	Fort	burcht
Bank		banke	bonke	banken
Ressort		ressort
Heide		heide	heyde
Bocht		bocht
